[
    {
      "layout": [
        "=====1======",
        "=          =",
        "=  @       =",
        "=          =",
        "=          =",
        "=          =",
        "=          =",
        "=          =",
        "=       i  =",
        "=          =",
        "============"
      ],
      "doors": {
        "1": {
          "isEnd": true
        }
      }
    }
  ]